##################-
#____P____P______#-
#____C___________#-
#_________C______#-
#______###########-
#________________#-
#____#_____#_____#-
#________________#-
#___#_______#____#-
#____#######_____#-
#________________#-
##################-