##############-----
#____P____P__#-----
#____C____C__#-----
#____________######
#C________________#
#_######_##########
#________#---------
#P_______#---------
##########---------
-------------------
-------------------
-------------------