----#####----------
----#___#----------
----#C__#----------
--###__C##---------
--#______#---------
###_#_##_#---######
#___#_##_#####___P#
#_C__C___________P#
#####_###_#_##___P#
----#P____#########
----#######--------
-------------------
